11111111111111111111111111111
100000X000C00X000000X000000E1
10100100C010000010X0010001111
1P00000111000C0X0X00X00X11111
111X001X0C0111111111111111111
11111111111111111111111111111