1111111111111111111
1000000000000000001
1010010100100000101
1P00C000000000000E1
1110000000011111111
1111111111111111111