1111111111111111111
1000000000C00000001
10100100C0100000101
1P00000111000C0X0E1
111X001X0C011111111
1111111111111111111