1111111111111111111
1X00000000C000000X1
10100100C1100X00001
1P0011111000C0X0E11
111100X00C011111111
1111011101111111111
1111111111111111111