1111111111111111111
1E0000000000000C001
1010010100100000101
1010010010101010001
1P0000000C00C000001
1111111111111111111