1111111111111
1EX0000000001
1010101010101
1010101010101
1P00000000001
1111111111111